@@@@@@@@@@@@@@@@@@@
@G    @  E  @    G@
@ @@@ @@@ @@@ @@@ @
@ @    @   @    @ @
@E  @@   H   @@  E@
@ @    @   @    @ @
@ @@@ @@@ @@@ @@@ @
@G    @  E  @    G@
@@@@@@@@@@@@@@@@@@@